111111111111111111111111111111111
1001000C0000000000000000000000001
100000001100000000000000000000001
1P0000000000000000000000000000001
10000000000000000000000C000000001
100000000000000000000000000000001
10000000000000000000000C000000001
100000000000001111111000000000001
100000000000000000001000000000001
100000000000000000001000000000001
10000000000000000000100C000000001
100000000000000000000000000000001
1001000C0000000000000000000000001
100000001100000000000000000000001
100000000000000000000000000000001
10000000000000000000000C000000001
100000000000000000000000000000001
10000000000000000000000C000000001
100000000000001111111000000000001
100000000000000000001000000000001
100000000000000000001000000000001
10000000000000000000100C000000001
100000000000000000000000000000001
1001000C0000000000000000000000001
100000001100000000000000000000001
100000000000000000000000000000001
10000000000000000000000C000000001
100000000000000000000000000000001
10000000000000000000000C000000001
100000000000001111111000000000001
100000000000000000001000000000001
100000000000000000001000000000001
10000000000000000000100C000000001
100000000000000000000000000000001
1001000C0000000000000000000000001
100000001100000000000000000000001
100000000000000000000000000000001
10000000000000000000000C000000001
100000000000000000000000000000001
10000000000000000000000C000000001
100000000000001111111000000000001
100000000000000000001000000000001
100000000000000000001000000000001
10000000000000000000100C000000001
100000000000000000000000000000001
1001000C0000000000000000000000001
100000001100000000000000000000001
100000000000000000000000000000001
10000000000000000000000C000000001
100000000000000000000000000000001
10000000000000000000000C000000001
100000000000001111111000000000001
100000000000000000001000000000001
100000000000000000001000000000001
10000000000000000000100C000000001
100000000000000000000000000000001
1001000C0000000000000000000000001
100000001100000000000000000000001
100000000000000000000000000000001
10000000000000000000000C000000001
1000000E0000000000000000000000001
10000000000000000000000C000000001
100000000000001111111000000000001
100000000000000000001000000000001
100000000000000000001000000000001
10000000000000000000100C000000001
100000000000000000000000000000001
1001000C0000000000000000000000001
100000001100000000000000000000001
100000000000000000000000000000001
10000000000000000000000C000000001
100000000000000000000000000000001
10000000000000000000000C000000001
100000000000001111111000000000001
100000000000000000001000000000001
100000000000000000001000000000001
10000000000000000000100C000000001
100000000000000000000000000000001
1001000C0000000000000000000000001
100000001100000000000000000000001
100000000000000000000000000000001
10000000000000000000000C000000001
100000000000000000000000000000001
10000000000000000000000C000000001
100000000000001111111000000000001
100000000000000000001000000000001
100000000000000000001000000000001
10000000000000000000100C000000001
100000000000000000000000000000001
1001000C0000000000000000000000001
100000001100000000000000000000001
100000000000000000000000000000001
10000000000000000000000C000000001
100000000000000000000000000000001
10000000000000000000000C000000001
100000000000001111111000000000001
100000000000000000001000000000001
100000000000000000001000000000001
10000000000000000000100C000000001
100000000000000000000000000000001
1001000C0000000000000000000000001
100000001100000000000000000000001
100000000000000000000000000000001
10000000000000000000000C000000001
100000000000000000000000000000001
10000000000000000000000C000000001
100000000000001111111000000000001
100000000000000000001000000000001
100000000000000000001000000000001
10000000000000000000100C000000001
100000000000000000000000000000001
1001000C0000000000000000000000001
100000001100000000000000000000001
100000000000000000000000000000001
10000000000000000000000C000000001
100000000000000000000000000000001
10000000000000000000000C000000001
100000000000001111111000000000001
100000000000000000001000000000001
100000000000000000001000000000001
10000000000000000000100C000000001
100000000000000000000000000000001
1001000C0000000000000000000000001
100000001100000000000000000000001
100000000000000000000000000000001
10000000000000000000000C000000001
100000000000000000000000000000001
10000000000000000000000C000000001
100000000000001111111000000000001
100000000000000000001000000000001
100000000000000000001000000000001
10000000000000000000100C000000001
100000000000000000000000000000001
1001000C0000000000000000000000001
100000001100000000000000000000001
100000000000000000000000000000001
10000000000000000000000C000000001
100000000000000000000000000000001
10000000000000000000000C000000001
100000000000001111111000000000001
100000000000000000001000000000001
100000000000000000001000000000001
10000000000000000000100C000000001
100000000000000000000000000000001
1001000C0000000000000000000000001
100000001100000000000000000000001
100000000000000000000000000000001
10000000000000000000000C000000001
100000000000000000000000000000001
10000000000000000000000C000000001
100000000000001111111000000000001
100000000000000000001000000000001
100000000000000000001000000000001
10000000000000000000100C000000001
100000000000000000000000000000001
1001000C0000000000000000000000001
100000001100000000000000000000001
100000000000000000000000000000001
10000000000000000000000C000000001
100000000000000000000000000000001
10000000000000000000000C000000001
100000000000001111111000000000001
100000000000000000001000000000001
100000000000000000001000000000001
10000000000000000000100C000000001
100000000000000000000000000000001
1001000C0000000000000000000000001
100000001100000000000000000000001
100000000000000000000000000000001
10000000000000000000000C000000001
100000000000000000000000000000001
10000000000000000000000C000000001
100000000000001111111000000000001
100000000000000000001000000000001
100000000000000000001000000000001
10000000000000000000100C000000001
100000000000000000000000000000001
1001000C0000000000000000000000001
100000001100000000000000000000001
100000000000000000000000000000001
10000000000000000000000C000000001
100000000000000000000000000000001
10000000000000000000000C000000001
100000000000001111111000000000001
100000000000000000001000000000001
100000000000000000001000000000001
10000000000000000000100C000000001
100000000000000000000000000000001
1001000C0000000000000000000000001
100000001100000000000000000000001
100000000000000000000000000000001
10000000000000000000000C000000001
100000000000000000000000000000001
10000000000000000000000C000000001
100000000000001111111000000000001
100000000000000000001000000000001
100000000000000000001000000000001
10000000000000000000100C000000001
100000000000000000000000000000001
111111111111111111111111111111111