1111111111111111111111111111111111
1E000000000000010011C1100000000001
1010010100100000101001000000010101
1010010010101010001001000000010101
1P00000001001000000000000000000011
1111111111111111111111111111111111