111111111111111
1E111C11C1M0001
10000000010CC01
11110111000CC01
11M000M1M000001
111101111000111
1C0000MC101P0C1
101010101010011
1CM0000C0000001
111111111111111