1111111
111E111
1110111
1M00001
100C001
10000M1
111C111
111P111
1111111