111111111111111111111111
111C1M0000000001M00000C1
11E000000CM000100000M111
1110000001P000C000000C11
111111111111111111111111